cou: councillorsの略: 参議院
rep: representativesの略: 衆議院

pro: proportional(比例)の略:
block: 選挙区

rul: ruling party: 与党
opp: opposition party: 野党

自民: ZIMIN
公明: KOUMEI
立民: RIKKEN
維新: ISIN
国民: KOKUMIN
共産: KYOSAN
れいわ: REIWA
社民: SHAMIN
Ｎ党: NHK
ファ: FA
新風: SINPU
幸福: KOFUKU
ごぼう: GOBOU
参政: SANSEI
くに: KUNI
第一: DAIITI
諸派: SHOHA
無: MUSHOZOKU

参議院・比例選挙
第26回: 2022/7/10: cou_pro_26.json:
    --- 人数 ---
    改選前の人数
        改選・非改選
        与党の人数
        野党の人数
    改選後の人数
        与党の人数
        野党の人数
    ------------

    --- 今回の選挙の政党と人数のマップ ---
    ※ https://www.nhk.or.jp/senkyo/database/sangiin/

    party_num_map
        old_power: 選挙前勢力
        new_power: 新勢力
        not_change: 非改選
        change: 改選
        new_win
            new_win: 今回の当選(選挙区+比例代表の数 or 現+元+新の数)
            block: 選挙区
            pro: 比例代表
            current: 現(おそらく連続当選)
            former: 元(おそらく非連続当選)
            newcomer: 新(おそらく新規の当選)
            


    -------------------------
